10x15
##########
#  C    C#
#    ### #
# %###X  #
# # # ## #
# C#    ##
## #   # #
#  %###C #
##  C #  #
##     C #
###  C  &#
#  # C  ##
#    #   #
#@#C#  C #
##########
2
2x3|1x13
3x7|1x13
