10x15
##########
# C #   @#
##    C# #
##&C#   ##
# ###   C#
## #     #
#       ##
#       ##
#C    C###
# %#     #
## #  C% #
# #X# #  #
#C# # # ##
# ## %# %#
##########
4
8x13|4x13
5x13|1x13
10x7|3x12
2x9|4x1
