10x15
##########
#   %C## #
#  #C#  C#
#  #   # #
# #  C  ##
#   # # ##
#    C % #
##    ####
##   #C# #
#   ## # #
# #%#X # #
#C #### ##
# #& C # #
#  C #  @#
##########
3
4x1|6x9
7x6|8x6
3x10|8x6

