10x11
##########
#@   C%C%#
#####C C #
### # #  #
##  % ####
#CCC  CC #
#CCCC##C #
#CC   #& #
#CC # # C#
#C% #X%  #
##########
5
6x1|8x2
8x1|6x2
4x4|3x9
2x9|4x5
6x9|1x1
