13x20
#############
##  #%   #  #
#   ##C##   #
#  #     ## #
# #     # X #
#  CC   #####
#    #CC# # #
# #  &      #
## C   #   ##
# # %##   # #
# #   #     #
##C #C#######
#    C#  % @#
# #  #     ##
##     #    #
#         % #
##  C#  # C #
#   ###   # #
#  C  #   #%#
#############
5
5x1|11x1
11x18|1x10
9x12|1x10
4x9|1x10
10x15|1x10
