10x15
##########
#@ CC  C#
#   ##   #
#  #    %#
###   # ##
#      # #
## ##### #
# #     ##
####  ## #
#%###  C #
#C# %   ##
#X# ##&# #
### % C  #
##       #
##########
4
8x3|5x10
4x10|1x1
4x12|1x10
1x9|2x13