10x15
##########
#@#% C C%#
# ###C C #
# # # #  #
# #      #
#C#C  CC #
#C#CC #C #
#C#   #& #
#C# #%# C#
#C# #X#  #
#C# # # C#
#C# #%# C#
#C# # # C#
#CC # # C#
##########
3
3x1|1x1
8x1|1x1
5x8|5x13
5x11|5x10

